###############
#*************#
#**H***V***D**#
#*************#
#******-******#
#*************#
#*************#
#*************#
###############

###############
#*************#
#******-******#
#*************#
#*************#
#+++++++++++++#
#*************#
#**0*******0**#
###############

###############
#*************#
#******-******#
#*************#
#+++++++++++++#
#*************#
#******2******#
#**5**********#
###############

###############
#*************#
#******H******#
#*************#
#*************#
#*************#
#*************#
#******-******#
###############

###############
#*************#
#******S******#
#*************#
#*************#
#*************#
#*************#
#******-******#
###############

###############
#*************#
#******D******#
#*************#
#*************#
#*************#
#*************#
#******-******#
###############

###############
#*************#
#******V******#
#*************#
#*************#
#*************#
#*************#
#******-******#
###############

###############
#*************#
#******6******#
#*************#
#*************#
#*************#
#*************#
#******-******#
###############

